#####B#
##### #
####  #
#### ##
#    ##
#A#####
